species_name status
zebra_finch	NA 
rat	1
panda	NA
marmoset	0
fugu	NA
coelacanth	NA
bushbaby	1
turkey	NA
stickleback	NA
sheep	1
mouse_lemur	1
gorilla	0
zebrafish	0
armadillo	NA
pig	1
mouse	1
dolphin	NA
chinese_rhesus	0
tenrec	NA
shrew	1
microbat	0
rabbit	1
orangutan	0
manatee	NA
nile_tilapia	0
lizard	NA
cow	1
wallaby	1
pika	NA
medaka	0
cat	1
rock_hyrax	NA
hedgehog	NA
naked_mole-rat	NA
human	0
elephant	1
platypus	1
guinea_pig	0
sloth	NA
chicken	1
kangaroo_rat	NA
budgerigar	NA
chimp	0
tetraodon	NA
tarsier	0
x_tropicalis NA
tasmanian_devil	NA
alpaca	NA
painted_turtle	NA
squirrel_monkey	0
atlantic_cod	0
megabat	0
squirrel	1
baboon	NA
gibbon	0
horse	1
opossum	NA
dog	1
tree_shrew	1